    █▓▒◘◘◘◘◘▒▓█                         
    █▓▒◘◘◘◘◘▒▓█                         
    █▓▒◘◘◘◘◘▒▓█                         
    █▓▒◘◘◘◘◘▒▓█                         
    █▓▒◘◘◘◘◘▒▓█▄▄▄▄▄▄▄▄▄▄▄▄▄▄▄▄▄▄▄▄     
    █▓▒◘◘◘◘◘▒▓▓▓▓▓▓▓▓▓▓▓▓▓▓▓▓▓▓▓▓▓█     
    █▓▒◘◘◘◘◘▒▒▒▒▒▒▒▒▒▒▒▒▒▒▒▒▒▒▒▒▒▓█     
    █▓▒◘◘◘◘◘◘◘◘◘◘◘◘◘◘◘◘◘◘◘◘◘◘◘◘◘▒▓█     
    █▓▒◘◘◘◘◘◘◘◘◘◘◘◘◘◘◘◘◘◘◘◘◘◘◘◘◘▒▓█     
    █▓▒◘◘◘◘◘◘◘◘◘◘◘◘◘◘◘◘◘◘◘◘◘◘◘◘◘▒▓█     
    █▓▒◘◘◘◘◘◘◘◘◘◘◘◘◘◘◘◘◘◘◘◘◘◘◘◘◘▒▓█     
    █▓▒◘◘◘◘◘◘◘◘◘◘◘◘◘◘◘◘◘◘◘◘◘◘◘◘◘▒▓█     
    █▓▒▒▒▒▒▒▒▒▒▒▒▒▒▒▒▒▒▒▒▒▒◘◘◘◘◘▒▓█     
    █▓▓▓▓▓▓▓▓▓▓▓▓▓▓▓▓▓▓▓▓▓▒◘◘◘◘◘▒▓█     
    ▀▀▀▀▀▀▀▀▀▀▀▀▀▀▀▀▀▀▀▀█▓▒◘◘◘◘◘▒▓█     
                        █▓▒◘◘◘◘◘▒▓█     
                        █▓▒◘◘◘◘◘▒▓█     
                        █▓▒◘◘◘◘◘▒▓█     
                        █▓▒◘◘◘◘◘▒▓█     
                        █▓▒◘◘◘◘◘▒▓█     
                                        
                                        
                                        
                                        